15 11
0 0
12 2
010000010001000
011101010101010
000101000100010
110111111111110
010000000000000
011111111111110
010000000100010
010011001101010
010001000001000
011101111111111
000000000000000
