101 101
0 0
100 0
00000001010000000100000000000100000100000000000100000100000000010000010000010000010001000000010000000
11111101010011110101111111010111001100111111010101110111011111010011010100110101010101111101011111010
00000101010001010101000001010001000100000100010001000001010001010001010100010101010100010001000000010
01111101011101010101011111011101110111011101110111111101010101011111010111010101010111010111111111110
01000101000000010000010000010000010000010001000100000100010101010000010001000101000100010100000001000
01010101001111111111010111111111011111110011111101110111110101010111110111111101111111010100111101001
01010001000100000100010100010001000100010001000001010000010100000100000100000100000001010100000101000
01011111110101110111110101010101110101011101011111011111011111110101111101110111110101010111110111110
01010000010101000100010001000101000001000001010000010001000000010101010001000100010101010000010001000
01010011010101011101011111111101111111111111011111010101111111011101010011110101011101011111011101011
00010001000101010001000001000100000000000001000001000100000001000100010000010001010001000100010001010
01111101111101010011111101010101111111111101111101111111111101110111011111011111010111110100110011010
01000001000001010001000100010101000001000100000100010000000100010001000001000001010100010100010001000
01111111001111011101010111110101110101010111110111010111110111010101111101111101010101010101010101110
00000001000100000001010100000100000101010000010100010100000001010100000100000101000101000101010100010
11111101010111111111011101111111111101110111010100110111111101010111011111110101111101111111010111010
00010001010000010001000001000000010001000101010100010000010001010001010000010100000101000000010001010
00110111011111010011001111110101010011001101010111011111010011011101010101010111110101110011110111010
00000100010000010001000000010101010001000101010001010000010001000101010101010100010100010000010100010
00111111010111111101111111010101111101110101010011010111111101001101110101110100110111011111011100110
00000001010100000001010000010100000100000100010000010100000101000100000100000100010001000001000100000
11111101110101011101010111110111110111111100111111110101110101110111111111111101011101111101110100111
00000100000101010000010100000100000101000100010100000101010100010000000100000001000101000100000100010
01110111111101011111010111110101110101010111010101110101010111010011110111110011110101010111111111010
01000100000101000001010000010101010001010001010001000101010001010001000100010000010100010100000000010
11011101010111111101111111010101010111011101011101011101011101010101001101011111110111110101111111010
00010001010001000100010000010101000100010101000101010101000100010101000001000001000000010101000001000
00110111011101010111010111110101001100110101110101010101110111110101111111111101011111010111001101111
00000101000100010100010100000101000100000100000101010000010100000100000101000001010001010000000100000
01111101110111110101010111111101110111110111111111011111010100111111110101011111010101011111111111110
01000001000100010101010001000001000100010100000001000100010100010000010100010000010100010000000001000
01010111011100110101011101011111001111010111110101110101110111010101110100110101110111110111111101010
00010100010100000001000101010001000001010100000100000101000001010101000100010101000000010100000000010
11011101110101111111111101010101111101010101111111111101010011010101011111010101111111010111111111110
00010001000001010000000001010100000000010101000000000101010000010101010000010100000101010000000000010
00110111001111010111111111010111111111010101110111110101111100110111010011110111110101011111111111010
00010101000000010100000000010100000100010001000101000100000100010001010000010000010101000000000100010
01110101110111110101010111110101110100111111011101011111110111011101011111011111010101111101111101110
01000100010100010101010100010101000100010000010100010000010100010001000001000100010100010001000001010
01011111010101010111011101011101001111010111110101110011010100110101111101110111110101110111001111010
01010001000101010001000101000001000100000100000101000001010100000101000100010001000101000101000100010
01010101110101011101010101111111110111111100111101111101010111111101010101011101011101001101110111010
01000100010101000101010001000000010100010000000000010001010101000001010101010100010001000001010001000
01111111010101110101011111011111010101010011111111010011010101011111010111010111111101111101011101111
01000000010100010001010001010001010001010001000001010001010101010000010000010000000000010101000100000
01011111110111011111010011010101011101011111011101011101010101010111111111111101111111010101110111110
01010000000100010000010001000101000101010000010001000001010101010100000001000001000000000100000100010
01011111001100111111011101111101110101010011110011111111110101010100111101011111111111111101111101010
01000001000100000001000100000101010101000000010000000000010100010100000100010000000000000001000001010
01111101111111111101110111011101010111011111011111111111010111110111110111010011111111111111001111010
01010001000000000101010100010001010001010001010000000000010000000100000100010001000001000001000001010
01010101011111001101010101010111011101110101010011111111111111111101111101111101010101011101111101010
01010101010001000001000101010100000100000101010000010000000000000001010001000101010100010000000101000
01010111010101111111001101010101010111111101111101010011111101111111010011010101010101111111110101110
00010100010100000001000001010101010000000100000101000001000001010000010001010001010101000001000101000
11110101110111011101111111010101011101111111110111110111011111010111011101011111010101011101111101001
00000101000100010100000001010101010001000000010000010100010000000100010001000001010101010001000001000
01110101001101110111111101110101011111011100111111011100110011111101010011111101010111010101010111110
01000101000101000000000100010101000001010100000001000100010001000101010000010101010000010101010100010
01111101111101111111011111010111111101010111110111110111011101010101111111010101110011110111011101010
00000100010001000000010000010001000001010001000100000000010000010100000000000100010001010001000001010
11110111010111011111110111111101001111011101001100111111111111111111110011111111011101011101111111010
00000101000100010000000100000101000100010001000000010001000000010000010001000001010001010000010000010
01110101111111010011111101110101010101110101111111110101011111010111011101010111010011010111010011111
01000000000000010000000001010101010001000101000100000100010001000101010001010100010000010100010000000
01111111111111111111111111010101110011011111010101111111110101111101011111010100111101110111110011110
01000000010000010000000001000100010000010000010101000001000101000001010000010100010001000100010000010
01011111010111010100111111011101011111110111110101001111010101110101010111110111011111010101011111110
00010001010101000100000001010001000000010100010001000100010100010101000100010000010001010101000000000
00110101010101111111111101010111111111010101011101010100110111011101111101111100110101010101111111110
00000101010001000001010001010101000001000101000101010000010100000100000001000100000100010101000000010
11011111011101010101010011010101010101111101110101111111110111110111110101010101111111111101001101010
00010000010101010100010000010100010101000100010100010000000100010001000101010101000100000101000101010
11110111010101010111111111110111110111010111010111010111111101011101010111010111010101110101110101110
00000101000101010100000000000000000100010100010101010100000001000101010100010000010001010100010100000
01111101110101010101111111111101111101110100110101010100111111110101011101111111111111010101010111110
01000000000101010001000100000101000001000100010100000100010001000101000101000100000100010101010100010
01111111111101011111010101110111011111011111010100111111010101011101010101010101110111010111011101011
01000100000101010000010001000001010100010000010100010001010100010101010100010001000100010001000101000
01010101110101110101111111111101010101110101110111110101010111110101110111111111011101011101110101110
01010001000100010101000100000101010001000101010001000100010001000100000000010000010001010100010000010
01011111001111010111010101110101010111110101011101001111111101001101111111110111110111010111011111110
01010001000001010000010101010100010100010101000101000100000101000001000100010100000100010001010000000
01010011110101010011110101010111110101011101001101010101110101111111010101010101111101110011010011110
01010000010101010001000100010001000001000001000001010101000100000001010001000101000101000001010000010
01010101010111011111001111011101111111111111011111010101111111111101011111111101010101011101011101010
00010101010001000001000001010100000100000000010000010100000100000101010100000001010001010001000101010
00111101011101111101001101010111110111011111110111110111010100110101010100111101011111110101110111010
00000001010100000101000100000000010001010000010100010001010000010101010000000101000000000101000100010
11111111010100111101111111111111011101011111010101011101110111110101011111111101110111111101011100111
00000001010100010001000001000000000101000001000101000100010100010100010001000001010100000101010000000
00110011010111010111001101111111111101111101001101110111010101010111110101011111010100110111010011110
00010001010100010100000100000000000001000101000100010000010101000100000100010000010100010001010001010
01111101010100110111110111111111111111010101111101011111110101110111011111110011010111011101011101010
01000001010100010001000100000001000001010001000101000100000100010001010001000001000001010001010000010
01001101010111011101011101110101110101011111010111110101111111011101010101001111111111010101011111110
01000101010001000101010001010100000101000000010001000101000101000100010100000100010000010101000000010
01110111010101110101010111010111111111111111111101001101010101110101111111111101010111110111111111010
00010001010101000100010100010000000100000000000001000100010000010101000000000001000100010001000001000
11011101010101001111110111011111110100111111111111110111111111010111001111111111111101011101010011110
00000100000101000000000000000000010000000000000000000100000000010000000000000000000001000100010000000
