51 51
0 0
50 50
000100000001000000000001000000000000000001000000010
110111011101010111111101011101111111111101111101010
010001010100010100000001010001000000010101000001000
011101010111110111011111010101011111010101001111110
000101010001010001010001010101010001010101000100010
010101010101011101010101010101010101010101110101010
010101000101000101000101010101010101010000000101010
011101111101110101111101110111011101011111111101010
000001010000000101000100010000000001000001000001010
001111010111111101110111011111111101111101111111010
000100010100010001000001000000000100000100000001010
110111010101010111011101111111110111110111111101010
010100010101010100010001000000010001000001000001010
010100110101010101011101010111111101111101011111010
000100000101010101000100010100000001000101010000010
011111111101010101110111011101111111010111010101110
010000000101000100010001010001000000010000010101000
010111110101111101111101110111011111111111110101001
000100010001000001000001000100010001000001000101000
111111011111111111011111011100110101001111010111110
000001000000000100010001010000000101000000010001000
110101111101110101010101010011111101001111110101011
000101000001000101010100010000010001000100010101010
001101011111011101010111111111110011011101011101010
000100010000010001010000000000010001010001000100000
110111110011111101011111111111010101110011110111111
000100010001000101010000000100010100000000010000000
011101111101010101011101110101110111111111111111110
010001000000010001000001000101010001000000010000000
011101001111111111111111111101010111011111010111110
000100000100000000000000000101000100010001000100000
010111110100111111111111110101111101111101111100111
010000010100000100000000010101000101000100010100000
011111011111110111011101110101010101010101010111110
000101000000000100010001000100010001010001000001000
110101111111111100111111010111111111010111111111011
010100000100010000000100010100000000010100000000010
010100110101011111110100111101111101111101111111110
010100010001000000010100000101000101000101000000010
010101011111111111010111110101110101010101011101010
000101010001000000010000010001000100010001010101000
011111010101001111111111011111001111111111010101110
010000010101000100000100010100000000000101010101010
010111111101110101010101010100111101110101010101010
000100000000010101010001010000000101010100000101000
111100110111110111011111011111111101010111011101111
000100010100010001000101010000010001010001010001000
001101011101011101110101010011010011011101110011010
000001010001010001000100010001010001000100010000010
001111010011010011011100111101011101010111011111110
000001000001000000010000000001000001010000000000000
